

                                                                $

                          &


                                                             ###b###

                        *            =         #
                      ####         ######

                  $          @     $      $         $     $                          $                 $$$$$$
           C               ####                                                             ####                                 ####
          ###             ######           ###                             ### C            ######              ###              ######
        #######          ########   *    #######     S                C   #######      b   ########            #######          ########       I
###################b########################################    ###################################################################################
%%%%%%%%%%%%%%%%%%%%%%%%%%%%%%%%%%%%%%%%%%%%%%%%%%%%%%%%%%%%    %%%%%%%%%%%%%%%%%%%%%%%%%%%%%%%%%%%%%%%%%%%%%%%%%%%%%%%%%%%%%%%%%%%%%%%%%%%%%%%%%%%
